####################
##                ##
##   #        #   ##
##  S#  ####  #S  ##
## ###        ### ##
##      #  #      ##
##  #  #    #  #  ##
##  #     @    #  ##
##  #  #    #  #  ##
##      #  #      ##
## ###        ### ##
##  S#  ####  #S  ##
##   #        #   ##
##                ##
####################
