####################
#                  #
#                  #
#   S   #  #   S   #
#                  #
#       #  #       #
#   #  #    #  #   #
#   #     @    #   #
#   #  #    #  #   #
#       #  #       #
#                  #
#   S   #  #   S   #
#                  #
#                  #
####################
